阿姨	阿姨	àyí	aunt, child's address to woman of similar age as parents, girl, babysitter, aunty, elderly unattached woman, cr#4 eche attendant, maiden aunt, family nurse, nursery/cr#4eche attendant, nurse, mother's sister, auntie, nursery eche attendant, child's address to woman of similar age, one's mother's sister
啊	啊	ā	particle: used in direct address and exclamation; indicating obviousness/impatience/suggestion; used for confirmation
矮	矮	ǎi	short (of stature), low
矮小	矮小	ǎi xiǎo	short and small, low and small, undersized
愛國	爱国	àiguó	love one's country, patriotic
愛護	爱护	àihù	cherish, treasure, take good care of
安	安	ān	surname An, content, calm, still, quiet, safe, secure, in good health, to find a place for, to install, to fix, to fit, to bring (a charge against sb), to pacify, to harbor (good intentions), security, safety, peace, ampere
安置	安置	ānzhì	find place for, help settle down, arrange for
按時	按时	àn shí	on time, before deadline, on schedule
暗	暗	àn	unclear, dull, hidden, dim, dusk, secret, dark
暗示	暗示	ànshì	(drop a) hint, suggest
巴士	巴士	bāshì	bus
百貨	百货	bǎihuò	general merchandise
擺	摆	bǎi	place, put, arrange
擺動	摆动	bǎi dòng	to sway, to swing, to move back and forth, to oscillate
擺脫	摆脱	bǎituō	disembroil, free oneself, cast/shake off, fling_off, break away from, shake_off, disinvolve, disentangle, shake off, shift, wangle, cast off, extricate oneself from, shake, waste, free oneself from, disburden, ditch, manage, lose, cast, unload, extricate oneself, prescind, unship, slip, wriggle, shunt
敗	败	bài	defeat, fail, lose, counteract, be defeated, beat, spoil, decay, wither
辦事	办事	bànshì	dispose, handle affairs, work
包裹	包裹	bāo guǒ	to wrap up, to bind up, bundle, parcel, package, CL:個|个[ge4]
包含	包含	bāohán	comprehend, consist of, subtend, imply, boast, go, colligate, include, hold, encompass, embrace, bear, carry, comprise, incorporate, cover, embody, connote, consist in, house, subsume, contain
包括	包括	bāokuò	consist_of, consist of, subtend, embrace, comprise, incorporate, embody, involve, count, subsume, take_in, comprehend, incorporation, include, comprize, run, cover, package, consist in
薄	薄	bó	lacking in warmth, infertile, light, cold, weak, thin, despise, flimsy
寶	宝	bǎo	treasure
寶寶	宝宝	bǎobǎo	pet, sonny, darling baby, precious baby, baby, precious, poppet, sweetie, precious/darling baby
寶貝	宝贝	bǎobèi	treasured object, treasure, darling, baby, cowry, good-for-nothing, odd character
寶貴	宝贵	bǎoguì	valuable, precious
寶石	宝石	bǎoshí	precious stone, gem
保密	保密	bǎomì	maintain secrecy, hide, conceal, keep sth. secret, keep secret, hold_back
保守	保守	bǎoshǒu	conservative
抱	抱	bào	hold/carry in arms, adopt, hatch, brood
背景	背景	bèijǐng	context, circumstance, locale, background, ground, stage setting, mise en scene, groundwork, background knowledge, frame, milieu, backcloth, scene, setting, backdrop
倍	倍	bèi	-fold, multiplication, diameter, double, times, twice as much
被迫	被迫	bèipò	forced, be forced, be compelled/forced, be compelled
本科	本科	běn kē	undergraduate course, undergraduate (attributive)
笨	笨	bèn	dull, cumbersome, wooden-headed, clumsy, stupid, awkward
比分	比分	bǐ fēn	score
畢業	毕业	bìyè	graduate, finish school
畢業生	毕业生	bìyèshēng	alumnus, postgraduate, grad, alum, alumna, graduating class, graduate
避	避	bì	avoid, preclude, evade, repel, prevent, forbid, ward off, shun, keep away, forestall, foreclose, stay away from
避免	避免	bìmiǎn	forbear, preclude, refrain_from, forebear, escape, help, elude, leapfrog, refrain from, stave_off, evite, shun, obviate, avoid, evade, waive, help oneself, ward_off, ward, miss, avert, ward off, balk, refrain
編	编	biān	group, arrangement, arrange, invent, entwine, weave, organize, edit, compilation, write, invention, pleach, cook up, plait, make up, braid, raddle, fabricate, compose, compile, fabrication
辯論	辩论	biànlùn	argue, debate
標誌	标志	biāozhì	earmark, banner, standing for, logo, symbol, marker, stamp, sign, symbolization, mark, emblem, seal, logotype, symbolizing, blip, marking, insignia
表情	表情	biǎoqíng	brow, air, countenance, glow, look, cast, visage, expression, facial expression, gesture, business, dramatics, facial gesture
表揚	表扬	biǎoyáng	praise, commend
別	别	bié	don't
冰	冰	bīng	ice
冰箱	冰箱	bīngxiāng	frig, electric refrigerator, fridge, freezer, refrigerator, deepfreeze, icebox, reefer, cooler, refrigeratory
冰雪	冰雪	bīng xuě	ice and snow
兵	兵	bīng	fighter, troops, armed force, arms, dogface, pawn in Ch. chess, military, weapons, private, soldier, ranker, joe, army, pawn, rank-and-file soldier
並	并	bìng	to be side by side, simultaneously, and
不要緊	不要紧	bù yào jǐn	unimportant, not serious, it doesn't matter, never mind, it looks all right, but
不在乎	不在乎	bù zài hu	not to care
不管	不管	bùguǎn	conj.: no matter, regardless of
不然	不然	bùrán	conj.: otherwise, if not, or else
布置	布置	bùzhì	dispose, embellish, arrange, set up, lay, assign, fix up, upholster
步行	步行	bùxíng	hoof it, tread, ambulate, leg it, foot, pedestrianize, footslog, tramp, go on foot, hoof, step, locomote, walk
擦	擦	cā	swab, shave, spread on, scrape, apply sth. on, spread sth. on, touch lightly, wipe, grate, rub, put/spread on, brush past, brush, obliterate, chafe, efface, sweep, scratch, fray, put on, apply, besmear, put, polish, scrape into shreds, fret, scrub, mop, erase
才	才	cái	then and only then, just now, only (before a number)
材料	材料	cáiliào	making, aggregate, stuff, ingredients, food, ingredient, data, fodder, material, datum, stock, makings, data point, timber
財產	财产	cáichǎn	aught, belonging, fortune, material possession, cash, riches, substance, assets, property, wealth, belongings, estate, seizin, thing, holding, possession, means, goods, asset, pelf, money, propertied, seisin, res, having
財富	财富	cáifù	opulence, pile, worth, fortune, moneybag, riches, mammon, substance, wealth, wealthy, gold, lucre, means, shekel, pelf, opulency, money, oof, nabobery
採訪	采访	cǎifǎng	cover, interview, gather news
參考	参考	cānkǎo	consult, refer to
參與	参与	cānyū	participate in
操場	操场	cāochǎng	schoolyard, school ground, school yard, drill ground, sportsground, playing field, playground, sports ground
操作	操作	cāozuò	operate, manipulate
測	测	cè	measure out, conjecture, measure, infer, survey, fathom
測量	测量	cèliáng	survey, measure
測試	测试	cèshì	test
曾	曾	zēng	once, ever, before
茶葉	茶叶	cháyè	tea, tea leaf, tea leaves
產品	产品	chǎnpǐn	baby, brand, output, product, produce, end product, merchandise, fruitage, growth, manufacture, wares, production
長途	长途	chángtú	long-distance, long distance
常識	常识	chángshì	nous, reason, mother_wit, general knowledge, common_sense, mother wit, horse sense, public knowledge, common sense, sense, good sense, gumption, commonsense, wisdom
唱片	唱片	chàngpiàn	pressing, waxing, cut, disc, phonogram, phonograph record, record, disk, wax, phonorecord, platter, recording, gramophone record, phonograph recording
抄	抄	chāo	to make a copy, to plagiarize, to search and seize, to raid, to grab, to go off with, to take a shortcut, to make a turning move, to fold one's arms
抄寫	抄写	chāo xiě	to copy, to transcribe
潮	潮	cháo	tide, current, damp, moist, humid
潮流	潮流	cháoliú	stream, tidal flow, tidal_current, tideway, trend, movement, wind, sea, fashion, tide, tidal current
潮濕	潮湿	cháo shī	damp, moist
徹底	彻底	chèdǐ	thorough, drastic, exhaustive, outright, complete
沉	沉	chén	see 黑沉沉[hei1 chen1 chen1], to submerge, to immerse, to sink, to keep down, to lower, to drop, deep, profound, heavy
沉默	沉默	chén mò	taciturn, uncommunicative, silent
沉重	沉重	chén zhòng	heavy, hard, serious, critical
稱讚	称赞	chēng zàn	to praise, to acclaim, to commend, to compliment
成人	成人	chéngrén	grownup, adult, majority, manhood, grown-up
誠實	诚实	chéngshí	honest
誠信	诚信	chéng xìn	genuine, honest, in good faith, honesty, integrity
承擔	承担	chéngdān	bear, undertake, assume
承認	承认	chéngrèn	receive, acknowledge, okay, approbate, validate, recognize, avow, admittance, count, confess, sanctify, grant, countersign, avouch, admit, acknowledgement, reckon, own, sanction, give diplomatic recognition, concede, cede, give, ratify, agree, recognise, accept, recognition, yield, allow, endorse, profess
承受	承受	chéngshòu	bear, support, endure, inherit (legacy/etc.)
程序	程序	chéngxù	rules of order, parliamentary law, instruction, process, procedure, agenda, instance, parliamentary procedure, system, order, proceeding, programme, method, sequence, course, program
吃驚	吃惊	chī jīng	to be startled, to be shocked, to be amazed
遲到	迟到	chídào	tardy, be late, arrive late, be/come/arrive late, come, late, come/arrive late, be
尺	尺	chǐ	m.[standard]
尺寸	尺寸	chǐcùn	measurement, dimension
尺子	尺子	chǐ zi	rule, ruler (measuring instrument), CL:把[ba3]
衝	冲	chōng	charge, rush, dash
充電	充电	chōngdiàn	charge, electricize, refresh
充電器	充电器	chōng diàn qì	battery charger
充分	充分	chōngfèn	full, ample, abundant
蟲子	虫子	chóng zi	insect, bug, worm, CL:條|条[tiao2],隻|只[zhi1]
抽	抽	chōu	lash, whip, thrash
抽獎	抽奖	choū jiǎng	to draw a prize, a lottery, a raffle
抽煙	抽烟	chōuyān	smoke (pipe/etc.)
出口	出口	chūkǒu	export
出色	出色	chūsè	outstanding, remarkable, splendid
出售	出售	chūshòu	offer for sale, sell
出席	出席	chūxí	attend, be present
處於	处于	chǔyū	go, be in, be (in a certain condition)
處	处	chù	m.[general]
穿上	穿上	chuānshàng	assume, wear, put_on, slip, enclothe, put on
傳統	传统	chuántǒng	rule, patrimony, legacy, custom, heritage, convention, conventionality, routine, normal practice, common practice, tradition
窗戶	窗户	chuānghù	window, casement
窗臺	窗台	chuāng tái	window sill, window ledge
窗子	窗子	chuāng zi	window
春季	春季	chūn jì	springtime
純	纯	chún	pure, simple
純淨水	纯净水	chúnjìngshuǐ	pure water
詞彙	词汇	cíhuì	mental lexicon, vocabulary, wordbook, lexicon, word-stock, lexis, words and phrases
此	此	cǐ	this, det.: this, here
此外	此外	cǐwài	conj.: besides, in addition, moreover
次	次	cì	order, sequence, next
刺	刺	cì	stab, prick, assassinate, irritate, stimulate, criticize
刺激	刺激	cìjī	stimulate, provoke, irritate, upset
從此	从此	cóngcǐ	hereon, hence, henceforth, thereupon, therefrom, from now on, from then on
粗	粗	cū	wide (in diameter), thick
粗心	粗心	cū xīn	careless, thoughtless
促進	促进	cùjìn	rush, help, step_up, advancement, progress, acceleration, subserve, encourage, facilitate, anticipate, accelerate, assist, fillip, expedite, advance, promotive, boost, further, provoke, hurry, redound, cultivate, induce, hasten, catalyze, speed, promote, contribute, impel, promotion, push, forward, stimulate, whet
促使	促使	cùshǐ	incite, prod, prompt, spur, send, motive, induce, trigger, urge, bring on, cause, propel, shame, instigate, impel, actuate, motivate, bear on, push, get, move
促銷	促销	cùxiāo	merchandise, sell
措施	措施	cuòshī	measure, demarche, corrective, move, step
打	打	dǎ	generalized verb of doing with specific meaning determined by its object, strike, hit, fight, construct, forge, mix
答案	答案	dáàn	result, script, resolution, solution, answer, key
打敗	打败	dǎbài	rout, outplay, whip, scupper, wallop, mop up, finish, suffer a defeat, overrule, overwhelm, flog, rack up, whop, be beaten, overpower, subdue, overmatch, snooker, be defeated, larrup, outfight, overmaster, floor, whup, knock_off, best, drub, defeat, euchre, confound, lick, fall, outrival, worst, overthrow, convince, vanquish, beat, pip
打雷	打雷	dǎ léi	to rumble with thunder, clap of thunder
打掃	打扫	dǎ sǎo	to clean, to sweep
打折	打折	dǎ zhé	to give a discount
打針	打针	dǎ zhēn	to give or have an injection
大巴	大巴	dà bā	a big coach, tourist bus
大多	大多	dà duō	for the most part, many, most, the greater part, mostly
大方	大方	dà fāng, dà fang	expert, scholar, mother earth, a type of green tea, generous, magnanimous, stylish, in good taste, easy-mannered, natural and relaxed
大哥	大哥	dàgē	eldest brother, elder brother, gang leader
大規模	大规模	dà guī mó	large scale, extensive, wide scale, broad scale
大會	大会	dàhuì	synod, moot, conference, plenary meeting, congress, rally, plenum, mass meeting, plenary session
大姐	大姐	dà jiě	big sister, elder sister, older sister (also polite term of address for a girl or woman slightly older than the speaker)
大樓	大楼	dàlóu	mansion, massif, hall, block, manse, edifice, building, multi-storied building, residence, mansion house
大陸	大陆	dàlù	Ch. mainland
大媽	大妈	dà mā	father's elder brother's wife, aunt (affectionate term for an elderly woman)
大型	大型	dàxíng	large-size (machines/factories/etc.)
大爺	大爷	dà ye	arrogant idler, self-centered show-off, (coll.) father's older brother, uncle, term of respect for older man
大眾	大众	dàzhòng	the broad masses, roughscuff, the public, herd, concourse, commonality, riffraff, masses, commonness, the masses, throng, multitude, commonage, commonalty, plebeian, plebs, horde, the people/masses, community, the people, million, mass, public
代替	代替	dàitì	fill in, replace, supply, supersede, replacement, substitute for, surrogate, oust, substitute, stand_in, stand in, cover, supplant, take the place of, fill_in, sub
待遇	待遇	dàiyū	treatment (salary/etc.)
袋	袋	dài	pouch, bag, sack, pocket
戴	戴	dài	wear, put on (of accessories)
擔保	担保	dān bǎo	to guarantee, to vouch for
擔任	担任	dānrèn	hold the post of, take charge of, assume, take_charge, fill, shoulder, adopt, skipper, assume the office of, assume office of, act_as, take, act as, play, undertake, take over, take on
擔心	担心	dānxīn	worry, feel anxious
單	单	dān	singly, alone
單純	单纯	dānchún	simple, pure, plain, artless
單調	单调	dān diào	monotonous
單獨	单独	dāndú	tete-a-tete, apart, unaccompanied, individually, singly, solely, alone, on one's own
淡	淡	dàn	tasteless, light, wishy-washy, pale, thin, weak
導遊	导游	dǎo yoú	tour guide, guidebook, to conduct a tour
導致	导致	dǎozhì	bring, lead, bring_about, lead to, incite, result in, conduce, bring about, produce, bring_on, render, set off, spark_off, inspire, inflict, cause, land
倒閉	倒闭	dǎo bì	to go bankrupt, to close down
倒車	倒车	dǎo chē, dào chē	to change buses, trains etc, to reverse (a vehicle), to drive backwards
得意	得意	déyì	be proud of; be exalted; be complacent
得	得	děi	should be, need
燈光	灯光	dēngguāng	light, lighting, the light of a lamp, illuminance, glim, illumination, lamplight
登	登	dēng	to scale (a height), to ascend, to mount, to publish or record, to enter (e.g. in a register), to press down with the foot, to step or tread on, to put on (shoes or trousers) (dialect), to be gathered and taken to the threshing ground (old)
登記	登记	dēngjì	register, check in
登錄	登录	dēng lù	to register, to log in
登山	登山	dēngshān	engage in mountain-climbing, sport
的確	的确	díquè	certainly, surely
敵人	敌人	dírén	antagonist, enemy, enemy force, foeman, opponent, adversary, hostile force, foe, opposing force
底	底	dǐ	underside, bottom, base, end, ground
地方	地方	dìfāng	country, soil, terrain, part, clime, way, territory, room, neighbourhood, tinderbox, locality (as distinct from the central administrat, child, tract, province, position, respect, where, region, space, place, local
地面	地面	dìmiàn	(earth's) surface, ground, floor, region
地位	地位	dìwèi	station, estate, importance, appointment, character, footing, capacity, chair, estate of the realm, level, situation, status, standing, position, spot, connection, space, sphere, quality, place, condition
地下	地下	dìxià	subterranean, underground, secretly, subsurface, secret, secret activity
地址	地址	dìzhǐ	location, domicile, street address, address, name and address, destination
典型	典型	diǎnxíng	typical, representative
點名	点名	diǎn míng	roll call, to mention sb by name, (to call or praise or criticize sb) by name
電燈	电灯	diàn dēng	electric light, CL:盞|盏[zhan3]
電動車	电动车	diàndòngchē	Electric vehicle
電梯	电梯	diàntī	lift, elevator
電源	电源	diàn yuán	electric power source
頂	顶	dǐng	top, tip
定	定	dìng	decide
冬季	冬季	dōng jì	winter
動畫片	动画片	dòng huà piàn	animated film
動搖	动摇	dòngyáo	totter, unnerve, faze, fluctuate, jounce, falter, oscillate, enervate, seesaw, stagger, waver, depolarize, vibrate, shaken, ferment, wabble, shake, churn, teeter, vacillate, wobble, rock, weaken, agitate, unsettle, sway, vacillation, hesitate
豆腐	豆腐	doù fu	tofu, bean curd
獨立	独立	dúlì	stand alone
獨特	独特	dútè	special, distinctive, unique
獨自	独自	dúzì	unaccompanied, solely, by oneself, alone
堵	堵	dǔ	to stop up, (to feel) stifled or suffocated, wall, classifier for walls
堵車	堵车	dǔ chē	traffic jam, choking
肚子	肚子	dùzi	kyte, venter, womb, tummy, belly, stomach, paunch, abdomen, breadbasket, wame, tripe
度過	度过	dùguò	pass, spend (time/etc.)
鍛鍊	锻炼	duàn liàn	to toughen, to temper, to engage in physical exercise, to work out, (fig.) to develop one's skills, to train oneself
對比	对比	duìbǐ	ratio, correlation
對付	对付	duìfù	counter, deal/cope with, face, confront, cope with, fix, make do, handle, deal, tackle, deal with
對於	对于	duìyú	in regard) to, toward, at, for
多次	多次	duō cì	many times, repeatedly
多年	多年	duōnián	for many years
多樣	多样	duōyàng	diverse, multiform, various
多種	多种	duō zhǒng	many kinds of, multiple, diverse, multi-
惡心	恶心	ě xīn, è xīn	nausea, to feel sick, disgust, nauseating, to embarrass (deliberately), bad habit, vicious habit, vice
兒童	儿童	értóng	kid, nipper, enfant, tyke, youngster, small fry, minor, shaver, nestling, tike, child, chit, fry, children, infant, tiddler, small-fry
而	而	ér	conj.: and yet
而是	而是	érshì	conj.: if not A, then B
耳機	耳机	ěr jī	headphones, earphones, telephone receiver
二手	二手	èr shoǔ	indirectly acquired, second-hand (information, equipment etc), assistant
發揮	发挥	fāhuī	bring into play, give free rein to, develop (idea/etc.), elaborate
發票	发票	fā piào	invoice, receipt or bill for purchase
發燒	发烧	fāshāo	fever, kindle, feverish, temperature, run a temperature, run a fever, have a fever, have a temperature
法	法	fǎ	law, method, way, mode, standard, model, legalists, Legalist School, Buddhist doctrine, dharma, magic arts
法官	法官	fǎguān	sentencer, Bench, judiciary, judgeship, bench, tippet, wig, justice, judicature, magistrate, court, judge, jurist, recorder, hakim, justicer, judgship
法律	法律	fǎlù	constitution, juridical, legal, jus, judiciary, statute law, law, codex, legislation, jurisprudence, lex, code, Themis, statute, judicial, practice of law, prescript, forensic, natural law
法院	法院	fǎyuàn	judicature, (law) court, judicatory, bar, courthouse, law court, court, tribunal, judiciary, banc, court of justice, jug, banco, forensic
飜	翻	fān	to turn over, to flip over, to overturn, to rummage through, to translate, to decode, to double, to climb over or into, to cross, variant of 翻[fan1]
翻譯	翻译	fānyì	translate, interpret
煩	烦	fán	to feel vexed, to bother, to trouble, superfluous and confusing, edgy
反	反	fǎn	counter, revolt, rebel, oppose, combat
反而	反而	fǎnér	conj.: on the contrary, instead
反映	反映	fǎnyìng	reflect, mirror, make known
方	方	fāng	just, only just/then
方案	方案	fāngàn	formula, plan, scheme, projection, programme, proposal, schema, strategy, project, design, program
方針	方针	fāngzhēn	policy, guiding principle
放鬆	放松	fàngsōng	relax, slacken, loosen
非	非	fēi	not
肥	肥	féi	fat, fertile, loose-fitting or large, to fertilize, to become rich by illegal means, fertilizer, manure
分布	分布	fēnbù	be distributed (over an area), be scattered
分散	分散	fēnsàn	divert, diversify, diffract, disperse, deconcentrate, decentralize, dispel, disgregate, decentralization, scatter, distract, decentralise, shed, break up, dispersal
分手	分手	fēnshǒu	part, part company, separate, say good-bye, break up
分為	分为	fēnwéi	divide ... into, fall_into, divide(into)
…分之…	…分之…	 fēn zhī 	... is divided into ...
紛紛	纷纷	fēnfēn	in droves, one_after_another, numerous and in great confusion
奮鬥	奋斗	fèndòu	struggle, fight, strive
風格	风格	fēnggé	plan, signature, idiom, kind, aroma, manner, idiosyncrasy, negligence, style, mode, tone, expressive style, artistic style, touch
風景	风景	fēngjǐng	view, aspect, vista, panorama, scenery, prospect, scene, sight, landscape
風俗	风俗	fēngsú	mores, custom, public decency, manner, institution, ritual, Sunna, manners, rite, guise
封閉	封闭	fēngbì	resistant to anything new
否則	否则	fǒuzé	conj.: otherwise, if not, or else
夫婦	夫妇	fūfù	conjugality, couple, man_and_wife, husband and wife
夫妻	夫妻	fūqī	couple, spouse, pair, man and wife, husband and wife
夫人	夫人	fūrén	Lady, lady, memsahib, milady, Dona, Mistress, dona, grande dame, donna, Mrs, mum, Senora, grace, senora, Mrs., madam, Frau, miladi, missus, senhora, wife, ma'am, Madame, madame, missis, Ladyship, Signora, signora
符號	符号	fúhào	sign, denotation, mark, icon, symbolical, symbol, notation, token, insignia, note, symbolic
符合	符合	fúhé	fulfil, conform, fit, tally with, fill, come_up_to, cohere, satisfy, accord, coincide, assort, equate, answer, tally, consist, meet, be in keeping with, chime_in, fulfill, look, accord/tally with, relate, chime, live up to, square, accord with, conform to, correspond
付出	付出	fùchū	pay, expend
負擔	负担	fùdān	burden, load, encumbrance
附近	附近	fùjìn	neighborship, neighborhood, precinct, vicinity, neighbourhood
複製	复制	fùzhì	duplicate, reproduce
改善	改善	gǎishàn	improve, perfect
改正	改正	gǎi zhèng	to correct, to amend, to put right, correction, CL:個|个[ge4]
蓋	盖	gài	cover, seal, affix seal, surpass, top, prevail over
概括	概括	gài kuò	to summarize, to generalize, briefly, CL:個|个[ge4]
感興趣	感兴趣	gǎnxìngqù	be interested, be interested in
高潮	高潮	gāocháo	water, high_tide, crescendo, coming, high tide/water, high tide, climax, upsurge, eagre, springtide, tidemark, sexual climax, blowoff, orgasm, culmination, payoff, wave, high, high water
高價	高价	gāo jià	high price
高尚	高尚	gāo shàng	noble, lofty, refined, exquisite
高鐵	高铁	gāo tiě	high speed rail
格外	格外	géwài	piu, especially, all the more, helluva, particularly
隔	隔	gé	separate, cut off, impede
隔開	隔开	gé kāi	to separate
個別	个别	gèbié	specifically, very few, specific, one or two exceptional, individual, exceptional
個體	个体	gètǐ	unit, individual, individuality
各個	各个	gè gè	every, various, separately, one by one
根	根	gēn	m.[general]
根據	根据	gēnjù	on the basis of, according to
工程	工程	gōngchéng	process, construction, engineering, engineering project, project
公元	公元	gōng yuán	CE (Common Era), Christian Era, AD (Anno Domini)
供應	供应	gōngyìng	supply
共	共	gòng	totally, together, in all, in company, altogether
構成	构成	gòuchéng	constitute, form, compose, make up
構造	构造	gòuzào	constitution, configuration, make-up, build, anatomy, construction, structure, tectonic, fabric, compages, making, contexture, texture, conformation, apparatus, formation, architecture, makeup
購買	购买	gòumǎi	invest, take, buy, make purchases, go shopping, purchase
購物	购物	gòuwù	shopping
骨頭	骨头	gǔtóu	os, strong character, bone, character, person of a certain character
固定	固定	gùdìng	set, plant, imbed, fix, strap, jell, fixed, affix, peg, stick, clench, rivet, regularization, rigidify, embed, infix, anchor, fixate, hold, regularize, implant, stitch, stabile, engraft, fasten, immobilize, moor, peg down, flat
瓜	瓜	guā	melon, gourd, squash
怪	怪	guài	find sth. strange, blame
關	关	guān	shut, close, turn off, lock up, close down
關閉	关闭	guānbì	close, shut (down)
關於	关于	guānyū	about, with regard to, concerning
官	官	guān	government official, officeholder
官方	官方	guānfāng	authorities, official, authority, regime, authorization, government
光臨	光临	guāng lín	(formal) to honor with one's presence, to attend
光盤	光盘	guāng pán	compact disc, CD or DVD, CD ROM, CL:片[pian4],張|张[zhang1]
逛	逛	guàng	to stroll, to visit
歸	归	guī	return ... to, put in sb.'s charge, take refuge, turn over to, return sth. to, come together, belong, give back to, marry, converge, return, take refuge (in Buddha/etc.), go back to
規律	规律	guīlù	law, regular pattern
規模	规模	guīmó	magnitude, dimensions, extent, scale, scope
規則	规则	guīzé	rule, regulation
果實	果实	guǒshí	fruitery, fruitage, gains, fruits, fruit, fructification
過分	过分	guòfèn	excessively, over-
海水	海水	hǎishuǐ	waters, seawater, salt water, sea, the sea, brine
海鮮	海鲜	hǎixiān	seafood
含	含	hán	keep in mouth, cherish
含量	含量	hán liàng	content, quantity contained
含義	含义	hán yì	meaning (implicit in a phrase), implied meaning, hidden meaning, hint, connotation
含有	含有	hányǒu	have, involve, infer, imply, tinge, include, number, carry, contain
寒假	寒假	hán jià	winter vacation
寒冷	寒冷	hánlěng	cold, frigid
行業	行业	hángyè	metier, mystery, profession, line, game, craft, calling, trade, industry, biz, walk_of_life, racket, living
航班	航班	háng bān	scheduled flight, flight number, plane, scheduled sailing, sailing number, passenger ship
航空	航空	hángkōng	air, aerospace, aerial, air travel, air power, aeronautical, navigation, voyage, aviation, aeronautic
毫米	毫米	háo mǐ	millimeter
毫升	毫升	háo shēng	milliliter
好友	好友	hǎoyǒu	peer, chum, crony, great friend, good friend, brick
號碼	号码	hàomǎ	pressmark, call mark, identification number, (serial) number, call number, no., number
好	好	hǎo	good
合同	合同	hé tong	(business) contract, CL:個|个[ge4]
黑暗	黑暗	hēiàn	dark
紅包	红包	hóng bāo	money wrapped in red as a gift, bonus payment, kickback, bribe
後頭	后头	hoù tou	behind, in the back, the rear side, later, in future
厚	厚	hòu	thick, fat, magnanimous, favor, kind, generous, deep, strong in flavor, large, stress, profound, rich
呼吸	呼吸	hūxī	take a breather, respiratory, take a breath, respire, catch one's breath, inspire, breathe, rest, suspire, respiration
忽視	忽视	hūshì	ignore, overlook, neglect
戶	户	hù	m.[general]
護士	护士	hùshì	graduate nurse, nana, nurse, sister, trained nurse, (hospital) nurse
花	花	huā	spend, expend, cost
劃	划	huá, huà	to cut, to slash, to scratch (cut into the surface of sth), to strike (a match), to delimit, to transfer, to assign, to plan, to draw (a line), stroke of a Chinese character
懷念	怀念	huáiniàn	cherish memory of, think of
懷疑	怀疑	huáiyí	suspect, doubt
緩解	缓解	huǎn jiě	to bring relief, to alleviate (a crisis), to dull (a pain)
黃瓜	黄瓜	huáng guā	cucumber, CL:條|条[tiao2]
黃金	黄金	huángjīn	gold
回復	回复	huí fù	to reply, to recover, to return (to a previous condition), Re: in reply to (email)
滙	汇	huì	to remit, to converge (of rivers), to exchange, variant of 匯|汇[hui4]
彙報	汇报	huì bào	to report, to give an account of, report
匯率	汇率	huìlù	interchange, exchange rate, rate of exchange, exchange, exchange_rate
婚禮	婚礼	hūn lǐ	wedding ceremony, wedding, CL:場|场[chang3]
火	火	huǒ	fire;internal heat, anger, temper;firearms, ammunition
夥	伙	huǒ	companion, partner, group, classifier for groups of people, to combine, together
伙伴	伙伴	huǒ bàn	partner, companion, comrade
或許	或许	huòxǔ	possibly, in all probability, peradventure, conceivably, mayhap, likely, perhaps, perchance, probably, maybe, haply, in all likelihood, belike
貨	货	huò	commodity, idiot, money, blockhead, loading, goods
獲	获	huò	harvest, capture, obtain, get, catch, poll, be able to, reap, gather in, win
獲得	获得	huòdé	find, cop, acquirement, come_into, gain, draw, pick_up, pull, achievement, score, procure, come_by, get hold, purchase, nab, come upon, derive, latch, incur, achieve, make, bring, receive, arrive, come_out, pocket, obtain, luck into, sack, win, enter upon, pick up, garner, harvest, attain, come up, line up, extract, secure, possess, earn, reap, accrue, cover, take, acquire, get, arrive_at
獲獎	获奖	huò jiǎng	to win an award
獲取	获取	huò qǔ	to gain, to get, to acquire
幾乎	几乎	jīhū	chiefly, anear, about, near, just_about, most, well-nigh, almost, closely, practically, intimately, all but, nearly, just about, virtually, much, nigh
機構	机构	jīgòu	internal structure of an organization, motion, gadget, instrumentality, institute, organ, mechanism, gear, representation, mechanics, machinery, apparatus, establishment, institution, means, organization, agency, setup, delegacy, outfit
機遇	机遇	jī yù	opportunity, favorable circumstance, stroke of luck
積累	积累	jī lěi	to accumulate, accumulation, cumulative, cumulatively
激動	激动	jīdòng	boil, tingle, kindle, seethe, toss, inflammatory, tizz, excited, fire, throb, carry_away, ferment, effervesce, stirred, bespirit, heat, agitation, hound, agitate, invigorate, burnt, actuate, inflame, stir, agitated, excite, move, impassion
激烈	激烈	jīliè	drastic, fierce, heated, acute, sharp, intense
及格	及格	jí gé	to pass an exam or a test, to meet a minimum standard
極	极	jí	extraordinary, unusual, special, very, extremely, highly
極其	极其	jíqí	absolutely, extremely, very, parlous, heaps, utterly, entirely, miserably, goldarn, precious, exceedingly, passing, definitely, plaguily, passingly, totally, staving, goldurn, completely
即將	即将	jíjiāng	in a short time, promptly, on the point of, at once, instantly, pronto, immediately, shortly, without delay, tout-de-suite, right away, forthwith, presently, soon, in a few seconds, before long, straightaway, in a minute, about to
急忙	急忙	jímáng	in haste, hurriedly
集合	集合	jíhé	gather, assemble, muster
記載	记载	jìzài	put down in writing, record
紀律	纪律	jìlù	disciplinary, discipline, ferule, morale, regime, laws and regulations
技巧	技巧	jìqiǎo	technics, artifice, superior skill, acquisition, acquirement, cunning, trick, dexterity, accomplishment, mechanism, craft, craftsmanship, technique, artistry, handiwork, mastery, handicraft, finesse, attainment, sleight, skill, implement, execution, prowess, ingenuity, art, method, dish, mechanics, knack, cup of tea, management, bag, proficiency, address, facility, virtuosity, workman
係	系	xì	be
季	季	jì	surname Ji, season, the last month of a season, fourth or youngest amongst brothers, classifier for seasonal crop yields
季度	季度	jì dù	quarter of a year, season (sports)
季節	季节	jìjié	season
既	既	jì	conj.: since...then
既然	既然	jìrán	conj.: since, as, now that
寄	寄	jì	attach oneself to, drop, transport, mail, ship, leave, entrust, post, get off, lodge at, depend on, send, entrustment, deposit, transmit, place, consign
加班	加班	jiā bān	to work overtime
加入	加入	jiārù	join, accede to
加油站	加油站	jiāyóuzhàn	pit, petrol_station, filling station, gasoline station, filling_station, gas station, gas_station, petrol station
家務	家务	jiā wù	household duties, housework
假如	假如	jiǎrú	conj.: if, supposing, in case
堅固	坚固	jiān gù	firm, firmly, hard, stable
檢測	检测	jiǎn cè	to detect, to test, detection, sensing
減	减	jiǎn	knock_down, derogate, cut, lessen, reduce, subtraction, diminish, reduction, decrease, dwindle, subtract, minus, deduct
減肥	减肥	jiǎnféi	lose weight
減少	减少	jiǎnshǎo	reduce, decrease
簡歷	简历	jiǎn lì	curriculum vitae (CV), résumé, biographical notes
健身	健身	jiàn shēn	to exercise, to keep fit, to work out, physical exercise
漸漸	渐渐	jiànjiàn	gradually, by degrees, little by little
江	江	jiāng	river
講究	讲究	jiǎngjiù	be particular about, pay attention to, stress, strive for, backbite
講座	讲座	jiǎngzuò	lecture, professorship, cathedra, talk-in, course of lecture, chair, course of lectures
獎	奖	jiǎng	award, prize, reward
獎金	奖金	jiǎngjīn	pewter, gainings, money award, gratuity, bounty, stakes, subsidy, prix, premium, incentive, prize money, perquisite, purse, winnings, stake, prize, bonus, gratification
獎學金	奖学金	jiǎngxuéjīn	burse, stipend, foundation, exhibition, studentship, scholarship
降	降	jiàng	fall, drop, lower
降低	降低	jiàngdī	reduce, cut down, drop, lower
降價	降价	jiàngjià	lower prices
降落	降落	jiàngluò	descend, land, drop (in water level, etc.)
降溫	降温	jiàng wēn	to become cooler, to lower the temperature, cooling, (of interest, activity etc) to decline
交換	交换	jiāohuàn	reciprocate, switching, barter, exchange, commute, switch, communicate, interchange, bandy, shift, trade, batter, truck, swop, change, counterchange, swap, clear, buy, transpose, change over, commune, turn around
交際	交际	jiāo jì	communication, social intercourse
教授	教授	jiàoshòu	professor
教訓	教训	jiàoxùn	lesson, moral
階段	阶段	jiēduàn	staged, period, phase angle, stage, gradation, level, peg, grade, remove, phase, leg, step
街道	街道	jiēdào	neighborhood, mews, gate, residential district, neighbourhood, street
節省	节省	jié shěng	saving, to save, to use sparingly, to cut down on
結	结	jié	tie, knit, knot, weave, congeal, form, forge, cement, settle, conclude
結構	结构	jiégòu	constitution, configuration, framing, structural, design, underframe, framework, construction, structure, schematism, economy, fabric, mechanics, composition, machinery, contexture, texture, constellation, fable, ordonnance, skeleton, organization, frame, architecture, chemistry, make
結論	结论	jiélùn	ultimate, sequitur, consequent, ending, close, inference, closing, end matter, afterword, consequence, verdict, finality, back matter, conclusion, peroration, summation, summing-up, end, upshot, illation, outcome, conclusion (of a syllogism)
姐妹	姐妹	jiě mèi	sisters, siblings, sister (school, city etc)
解釋	解释	jiěshì	explain, interpret, analyze
儘快	尽快	jǐnkuài	as quickly/soon as possible
緊密	紧密	jǐnmì	settle, close together, rapid and intense, compact, inseparable, close
盡力	尽力	jìnlì	do_one's_best, do all one can, render, take pains, be at pains, take_pains, stretch, strain, strive, try one's best
進口	进口	jìnkǒu	import
近代	近代	jìn dài	the not-very-distant past, modern times, excluding recent decades, (in the context of Chinese history) the period from the Opium Wars until the May 4th Movement (mid-19th century to 1919), capitalist times (pre-1949)
禁止	禁止	jìnzhǐ	estop, inhibit, bar, outlaw, banish, forbid, suppress, interdict, defend, taboo, veto, prohibit, enjoin, blackball, restrain, debar, proscribe, negative, disallow, relegate, nix, prohibition, ban
經典	经典	jīngdiǎn	canon, classic, classics, sutra, scriptures, scripture, Bible
精力	精力	jīnglì	stamina, get-up, birr, spirits, vigor, energy, cheer, vinegar, vim, whiz, pride, starch, get-up-and-go, mercury, zing, ginger, sap, verve, zip, git-up, pizazz, power, sinew, go, dynamism, oomph, vigour, foison, ambition, moxie, gimp, peppiness, pazazz, pep, pizzaz, snap, stingo, spirit, drive, pith, pizzazz, last, push, steam
竟然	竟然	jìngrán	unexpectedly, to one's surprise
鏡頭	镜头	jìngtóu	training, lens, scene, shot, camera lens, vertex, optical lens
鏡子	镜子	jìngzi5	looking_glass, gaper, looking glass, mirror, spectacles, glass, glasses
究竟	究竟	jiùjìng	actually, exactly, after all, in the end
酒吧	酒吧	jiǔ bā	bar, pub, saloon, CL:家[jia1]
居民	居民	jūmín	municipality, population, citizen, denizen, townie, people, dweller, populace, residenter, resident, towny, inhabitant, habitant, liver
居住	居住	jūzhù	inhabit, occupy, shack_up, locate, domicile, shack, abide, subsist, settle, live, howff, reside, indwell, populate, lodge in, quarter, dwell, people, belong, bide, hang_out, house, residence
局	局	jú	m.[event]
巨大	巨大	jùdà	gigantic, gargantuan, huge
具備	具备	jùbèi	be provided with, supply, render, have, furnish, possess, provide, possession
距離	距离	jùlí	distance
聚	聚	jù	get together, assemble, forgather, gather
聚會	聚会	jùhuì	get-together, gathering
卷	卷	juàn	volume, coil, furl, roll, spool, documents, m.[general], ,part, data file, tome, reel, book, examination paper, cylindrical mass of something, file, dossier
角色	角色	jiǎosè	theatrical role, character, persona, part, function, office, fictional character, actor, fictitious character, personage, role
開花	开花	kāihuā	burst forth, flower, bloom, split apart, explode, blossom, effloresce, unfold, feel elated, break apart, blow
開水	开水	kāi shuǐ	boiled water, boiling water
看不起	看不起	kàn bu qǐ	to look down upon, to despise
看來	看来	kànlái	it looks as if, it appears, it seems, it look as if
看望	看望	kàn wàng	to visit, to pay a call to
考察	考察	kǎochá	inspect, make on-the-spot investigation, observe and study
考慮	考虑	kǎolù	think over, consider
棵	棵	kē	head, tuft, m.[general],
可見	可见	kějiàn	therefore
空間	空间	kōngjiān	elbow room, allowance, margin, roomage, open air/sky/space, road, leeway, way, open air, sheets, room, tolerance, opening, clear, sky, spacial, interspace, vacuity, spatial, dimension, open sky/space, space, place, vacuum
空	空	kòng	free, with spare time
口袋	口袋	kǒudài	pocket
口語	口语	koǔ yǔ	colloquial speech, spoken language, vernacular language, slander, gossip, CL:門|门[men2]
苦	苦	kǔ	be troubled by, suffer from, cause sb. suffering, bitter
會計	会计	kuàijì	accountant, bookkeeper
快遞	快递	kuài dì	express delivery
寬	宽	kuān	wide, broad, generous, lenient, comfortably off, well-off, relax, relieve, extend
寬廣	宽广	kuānguǎng	wide, vast, extensive, broad
礦泉水	矿泉水	kuàng quán shuǐ	mineral spring water, CL:瓶[ping2],杯[bei1]
擴大	扩大	kuòdà	enlarge, expand, extend, swell, dilate
擴展	扩展	kuòzhǎn	expand, spread, extend
括號	括号	kuò hào	parentheses, brackets
垃圾	垃圾	lèsè	leavings, crap, sordes, trumpery, culch, garbage, filth, debris, cultch, sweeping, trashery, raffle, slush, truck, detritus, rubbish, trash, dirt, muck, litter, offscouring, offal, rubble, recrement, dust, rejectamenta, refuse, junk, gook
拉開	拉开	lā kāi	to pull open, to pull apart, to space out, to increase
辣	辣	là	hot (spicy), pungent
來不及	来不及	láibùjí	be too late to do sth.,
來得及	来得及	lái de jí	there's still time, able to do sth in time
來源	来源	láiyuán	resource, wellspring, origin, provenance, quarter, root, source, beginning, springhead, fodder, fount, quarry, fountain, mint, parentage, whence, paternity
老公	老公	lǎogōng	old man, eunuch, married man, hubby, husband
老家	老家	lǎojiā	native place, old home, one's original home
老婆	老婆	lǎopó	old lady, broomstick, missis, missus, married woman, squaw, old_lady, wife
老實	老实	lǎoshí	honest, frank, well-behaved, good, simple-minded, naive
樂趣	乐趣	lèqù	amusement, playfulness, fun, merriment, pleasure, sweet, delight, bang, entertainment, enjoyment, pleasance, joy
淚	泪	lèi	tear, lachrymal, teardrop, brine, eyewater
淚水	泪水	lèi shuǐ	teardrop, tears
類型	类型	lèixíng	category, species, genre, portrait, nature, stamp, cast, type
冷靜	冷静	lěngjìng	sober, calm
釐米	厘米	lí mǐ	centimeter
離不開	离不开	lí bu kāi	inseparable, inevitably linked to
力氣	力气	lìqì	physical strength, effort
歷史	历史	lìshǐ	past records, historical, history
立即	立即	lìjí	at_once, off-hand, promptly, at once, down, instantly, directively, straightway, herewith, thereupon, ex tempore, without_delay, pronto, right_away, instant, straight, immediately, in_short_order, right away, instanter, straightaway, in short order, off-the-cuff
利息	利息	lìxí	premium, usury, accrual, interest
利益	利益	lìyì	privilege, profit, vantage, favor, interest, behoof, account, goodness, gain, increment, avail, boon, plus, commodity, lucre, advantage, stead, boot, benefit, welfare, good, asset, behalf, percentage, stake, favour
倆	俩	liǎ	two (colloquial equivalent of 兩個|两个), both, some
良好	良好	liánghǎo	good, well
量	量	liáng, liàng	to measure, capacity, quantity, amount, to estimate, abbr. for 量詞|量词[liang4 ci2], classifier (in Chinese grammar), measure word
糧食	粮食	liángshí	victuals, victualage, provisions, nutrient, ration, sustentation, provision, provender, food, purveyance, sustenance, foodstuff, commissariat, cereals, bread, viands, grain
兩邊	两边	liǎng bian	either side, both sides
療養	疗养	liáo yǎng	to get well, to heal, to recuperate, to convalesce, convalescence, to nurse
了不起	了不起	liǎo bu qǐ	amazing, terrific, extraordinary
了解	了解	liǎojiě	understand, comprehend, find out, acquaint oneself with
列	列	liè	arrange, line up, list, enter in a list
列車	列车	lièchē	train
列入	列入	lièrù	be listed, be listed/placed, placed, be placed, rank
列為	列为	lièwéi	be classified as
臨時	临时	lín shí	as the time draws near, at the last moment, temporary, interim, ad hoc
零食	零食	líng shí	between-meal nibbles, snacks
流傳	流传	liúchuán	spread, circulate, hand down
樓梯	楼梯	lóutī	stairs, staircase
陸地	陆地	lù dì	dry land (as opposed to the sea)
陸續	陆续	lùxù	continuously, one after another, in succession
錄取	录取	lùqǔ	enroll, recruit, admit
律師	律师	lùshī	scribe, counsellor, advocate, gown, avocat, solicitor, barrister, lawyer, counsel, jurist, counselor, counselor-at-law, attorney
輪	轮	lún	m.[event]
輪船	轮船	lún chuán	steamship, steamer, ocean liner, ship, CL:艘[sou1]
輪椅	轮椅	lúnyǐ	wheelchair
輪子	轮子	lún zi	wheel, CL:個|个[ge4]
論文	论文	lùnwén	disquisition, memoir, paper, discourse, theme, treatise, thesis, article, tractate, dissertation
落	落	luò	come down, have, remain where one is, go under, leave behind, lower, decline, stay behind, lag behind, dip, precipitate, go down, be missing, fall/leave/stay behind, belong to, set (of sun), drop, ebb (of tide), set, receive, set down, drop behind, light, rest with, obtain, fall, leave/stay behind, fall onto, turn over to, fall behind, sink, get, ebb, land, leave out
毛巾	毛巾	máojīn	washcloth, flannel, Turkish towel, face towel, face cloth, hand_towel, towel, washrag, napkin, terry towel, hand towel
毛衣	毛衣	máo yī	(wool) sweater, CL:件[jian4]
帽子	帽子	màozi5	castor, lid, cap, brand, headgear, chapeau, titfer, hat, headpiece, label, amice, tag
沒錯	没错	méi cuò	that's right, sure!, rest assured!, that's good, can't go wrong
沒法兒	没法儿	mòfǎér	Can't
沒想到	没想到	méixiǎngdào	unexpectedly
美金	美金	měijīn	buck, dollar, U.S. dollar
美女	美女	měinǔ	looker, bombshell, siren, cookie, peach, dish, sweetheart, peri, lulu, beautiful woman, charmer, smasher, belle, knockout, mantrap, Venus, stunner, beauty, lovely
夢	梦	mèng	dream
夢見	梦见	mèng jiàn	to dream about (sth or sb), to see in a dream
夢想	梦想	mèngxiǎng	fond dream
秘密	秘密	mìmì	secret
秘書	秘书	mìshū	secretarial, secretary, clerk, amanuensis, secretarial assistant
密	密	mì	dense, thick, intimate, close
密碼	密码	mì mǎ	code, secret code, password, pin number
密切	密切	mìqiè	osculate, intimate, close
免費	免费	miǎnfèi	be free of charge, free_of_charge, gratuitous, gratis
面臨	面临	miànlín	have, face, confront, envisage, flank, present, be faced with, be up against, bide, meet
面試	面试	miàn shì	to be interviewed (as a candidate), interview
描述	描述	miáoshù	describe
描寫	描写	miáoxiě	describe, depict, portray
名牌兒	名牌儿	míngpái r	Famous brand
名片	名片	míngpiàn	visiting_card, calling card, card, pasteboard, visiting card, carte, namecard, calling_card, visiting
名人	名人	míngrén	notability, luminary, celebrity, don, celeb, hotshot, lion, famous person, eminent peron, anybody, name, adept, star, figure, man of mark, proficient, performer, personality, social lion, nob, famous peron, guiding light, article, eminent person, boss, famous/eminent person, famous, toff, leading light, notable, swell, personage
摸	摸	mō	feel out, sound out, fumble, feel for, palpate, feel, stroke, finger, try to find out, touch, grope for, feel/sound out
模特兒	模特儿	mótèēr	poser, artist's model, model
模型	模型	móxíng	formula, pattern, mould, mold, modeling, construct, die, convention, exponent, plaything, former, modelling, model, simulation, normal, rule, moulding, molding, shape, matrix, clay sculpture, restoration, toy
末	末	mò	tip, end
默默	默默	mòmò	quietly, silently
哪怕	哪怕	nǎ pà	even, even if, even though, no matter how
哪	哪	nǎ	det.: which
男女	男女	nánnǔ	men and women
男士	男士	nánshì	gent, man, men, menfolk
難免	难免	nánmiǎn	hard to avoid
腦袋	脑袋	nǎodài	head
鬧	闹	nào	give vent, be troubled by, give vent to anger, suffer from, make a noise, do, stir up trouble, make, go in for
鬧鐘	闹钟	nào zhōng	alarm clock
內部	内部	nèibù	entrails, bowel, interior, inner, within, bosom, inside, innards, internal, inward
內科	内科	nèi kē	internal medicine, general medicine
能幹	能干	néng gàn	capable, competent
寧靜	宁静	níngjìng	peaceful, tranquil, quiet
濃	浓	nóng	thick, concentrated, stress, favor, dense
女士	女士	nǔshì	senorita, lady, Ms., mum, Senora, educated girl, educated woman, madonna, madam, Miss, woman, ma'am, Madame, madame, gentlewoman, senhorita, dame, mademoiselle
暖氣	暖气	nuǎn qì	central heating, heater, warm air
拍照	拍照	pāizhào	take a picture, take (picture), shoot (film), snap, film, take a photograph, take, photograph, shoot
排列	排列	páiliè	arrange, put in order
牌	牌	pái	dominoes, plate, prosodic pattern for ^1 ci2 ^ or ^3 qu3, card, cards, cards, dominoes, etc., brand, tablet, prosodic pattern for ^1ci2^ or ^3qu3^
盤	盘	pán	m.[event]
盤子	盘子	pánzi5	plate, pan, salver, bowl, dish, tray
胖子	胖子	pàng zi	fat person, fatty
培訓	培训	péixùn	cultivate, train
培訓班	培训班	péi xùn bān	training class
培養	培养	péiyǎng	foster, train, develop, culture
培育	培育	péiyū	cultivate, foster, breed
批	批	pī	m.[general]
片面	片面	piàn miàn	unilateral, one-sided
品質	品质	pǐnzhí	calibre, appraisal, caliber, character, self, intrinsic, brew, quality, timber, sort
平方	平方	píng fāng	square (as in square foot, square mile, square root)
平靜	平静	píngjìng	calm, quiet, tranquil
平均	平均	píngjūn	average
平穩	平稳	píng wěn	smooth, steady
迫切	迫切	pòqiè	imminent, imperative, pressing, urgent
破產	破产	pòchǎn	go bankrupt, come to naught
妻子	妻子	qīzǐ	frow, feme, married woman, wifelike, wife, woman, femme, missis, squaw
期待	期待	qídài	look forward to
期間	期间	qíjiān	length, period, time period, amount of time, duration, course, interim, period of time, time, standing, chapter, tract, space, term, streak, efflux
期末	期末	qī mò	end of term
期限	期限	qíxiàn	time limit, allowed time, deadline, term
期中	期中	qī zhōng	interim, midterm
其餘	其余	qíyū	etceteras, det.: others, remainder, the rest
企業	企业	qǐyè	proposition, business enterprise, business organization, business concern, concern, commercial enterprise, endeavour, endeavor, industry, business, project, corporation, enterprise
氣球	气球	qì qiú	balloon
汽水	汽水	qì shuǐ	soda, pop
汽油	汽油	qì yoú	gasoline
器官	器官	qìguān	appendage, member, variety meat, penis, apparatus, organs, organ, transplant, phallus, extremity
前頭	前头	qián tou	in front, at the head, ahead, above
前途	前途	qiántú	lookout, future, prospects, prospect, futurity, career
淺	浅	qiǎn	shallow, superficial, easy, simple, light (of color)
巧克力	巧克力	qiǎo kè lì	chocolate (loanword), CL:塊|块[kuai4]
切	切	qiē	cut, slice
親愛	亲爱	qīn ài	dear, beloved, darling
親密	亲密	qīnmì	chum, intimate, close
青春	青春	qīngchūn	springtime, flower, prime, juvenility, youthfulness, one's youth, young adulthood, youth, prime of life, youthhood, juvenescence, may
輕鬆	轻松	qīngsōng	light, relaxed
輕易	轻易	qīngyì	lightly, rashly
清醒	清醒	qīngxǐng	waken, wake up, sober up, be wide-awake, be clear-headed, wide-awake, wake, be sober, awaken, be sober/wide-awake, sober, come alive, awake, come to, regain consciousness, arouse, sober_up
情景	情景	qíngjǐng	scene, sight, circumstances
窮	穷	qióng	exhaust, exhausted, impoverished, hard-pressed, pursue to limit, poor
窮人	穷人	qióngrén	pauper, poor people, prole, poor, poor man, the poor, beggar, have-not
秋季	秋季	qiū jì	autumn, fall
趨勢	趋势	qūshì	stream, gravitation, tendency, wind, tide, drift, sequel, trend, current, direction, inclination, tendence, momentum, flow
圈	圈	quān	m.[activity]
權利	权利	quánlì	privilege, claim, merit, title, entitlements, escheatage, right, dib, authority, competency, obligation, pretension, prescription, dibs
卻	却	què	however, but, yet, indeed
確認	确认	quèrèn	countersign, confirm, affirmation, identify with certainty, identify, acknowledgement, acknowledge, quiet, confirmation, recognize, seal, verify, uphold, affirm, notarize
然而	然而	ránér	conj.: even so, but
燃料	燃料	rán liào	fuel
燃燒	燃烧	ránshāo	burn
熱鬧	热闹	rènào	lively, buzzing with excitement
熱心	热心	rèxīn	be enthusiastic about
人家	人家	rénjiā	I (used by females), dwelling, I, sb. else, sb. else's house, family, household
日記	日记	rìjì	diary, journal
日曆	日历	rì lì	calendar, CL:張|张[zhang1],本[ben3]
如今	如今	rú jīn	nowadays, now
弱	弱	ruò	infirm, a little less than, young, inferior, weak, a bit less than, feeble
傘	伞	sǎn	fimbria, brolly, sth. shaped like an umbrella, umbrella, mush, gamp, bumbershoot
散	散	sàn	break up
掃	扫	sǎo, sào	to sweep, broom
色	色	sè, shǎi	color, CL:種|种[zhong3], look, appearance, sex, color, dice
色彩	色彩	sècǎi	hue, tincture, palette, tint, blazonry, leavening, tinct, grain, color, shade
耕	耕	gēng	to plow, to till
晒	晒	shài	air, cold-shoulder, soak up sun, sun-dry, shine on, sun upturned soil
閃	闪	shǎn	sprain, get out of the way, wink, shine, leave behind, have mishap, twist, sparkle, dodge, flash
閃電	闪电	shǎn diàn	lightning, CL:道[dao4]
善良	善良	shànliáng	good and kind, decent
善於	善于	shànyū	excel, surpass, stand out, be adept in, be good at
傷害	伤害	shānghài	harm
商務	商务	shāng wù	commercial affairs, commercial, commerce, business
賞	赏	shǎng	admire, enjoy
上個月	上个月	shàng gè yuè	last month
上樓	上楼	shàng loú	to go upstairs
上門	上门	shàng mén	to drop in, to visit, to lock a door, (of a shop) to close, to go and live with one's wife's family, in effect becoming a member of her family
燒	烧	shāo	oven broil, roast, burn, broil, run a fever, baking, stew ... in soy sauce, cook, heat, bake, burning, burnt, stew, grill, cooking, have a temperature
設施	设施	shèshī	installation, facilities
設置	设置	shèzhì	set/put up, install
申請	申请	shēnqǐng	apply for
身材	身材	shēncái	stature, figure
身份	身份	shēnfèn	state, dignity, station, estate, body, estate of the realm, capacity, status, standing, caste, doctorate, place, identity, condition
身高	身高	shēngāo	height, stature, height (of person)
深厚	深厚	shēnhòu	deep, profound, solid, deep-seated
神話	神话	shénhuà	fairy story, fairy tale, mythos, mythic, fable, fairytale, myth, mythology
神秘	神秘	shénmì	mysterious, mystical
甚至	甚至	shènzhì	even (to the point of), so much so that
失敗	失败	shībài	be defeated, fail, lose
失望	失望	shīwàng	become disappointed, lose (hope/faith)
失業	失业	shīyè	lose one's job; be out of work
詩	诗	shī	verse form, poem, canto, verse, rhyme, number, song, poesy, poetry
詩人	诗人	shīrén	muse, rhymist, swan, lark, Parnassus, Maker, minstrel, harmonist, metrist, maker, bulbul, songster, versifier, poet, singer, eisteddfod, bard
濕	湿	shī	humidify, moisten, humid, damp, dampen, wet
實施	实施	shíshī	put into effect, implement
實用	实用	shíyòng	practical, pragmatic, functional
食堂	食堂	shítáng	mess_hall, eatery, hall, buttery, commissariat, (institutional) dining room, mess hall, mess, refectory, dining room, canteen
使勁	使劲	shǐ jìn	to exert all one's strength
士兵	士兵	shìbīng	rank-and-file soldiers
市區	市区	shìqū	urban area, city proper, row, urban district, downtown, urban_area
似的	似的	shì de	seems as if, rather like, Taiwan pr. [si4 de5]
事物	事物	shìwù	proposition, pigeon, object, thing, affair, un
事先	事先	shìxiān	ahead, beforehand, in advance, in_advance, aforetime, aforehand
試卷	试卷	shì juàn	examination paper, test paper, CL:份[fen4],張|张[zhang1]
是否	是否	shìfǒu	whether or not, is it so or not
收回	收回	shōuhuí	take back, call in, recall, withdraw, countermand
收穫	收获	shōuhuò	harvest, gains, results
收益	收益	shoū yì	earnings, profit
手工	手工	shǒugōng	handwork
手裡	手里	shoǔ lǐ	in hand, (a situation is) in sb's hands
手術	手术	shǒushù	operation
手套	手套	shoǔ tào	glove, mitten, CL:雙|双[shuang1],隻|只[zhi1]
守	守	shǒu	guard, defend, keep watch
首	首	shǒu	m.[general]
受不了	受不了	shoù bù liǎo	unbearable, unable to endure, can't stand
售貨員	售货员	shoù huò yuán	salesperson, CL:個|个[ge4]
叔叔	叔叔	shúshú	father's younger brother, uncle, uncle (child's address for young males)
舒適	舒适	shūshì	comfortable, cozy
熟練	熟练	shú liàn	practiced, proficient, skilled, skillful
暑假	暑假	shǔ jià	summer vacation, CL:個|个[ge4]
樹林	树林	shùlín	forest, motte, woods, wood, planting, grove, timberland, woodland, hurst, timber
樹葉	树叶	shùyè	leaves, foliage, leafage, leaf, leave, leaves (of trees)
數據	数据	shùjù	data
數碼	数码	shù mǎ	number, numerals, figures, digital, amount, numerical code
刷	刷	shuā, shuà	to brush, to paint, to daub, to paste up, to skip class (of students), to fire from a job, to select
刷牙	刷牙	shuā yá	to brush one's teeth
刷子	刷子	shuā zi	brush, scrub, CL:把[ba3]
帥	帅	shuài	surname Shuai, handsome, graceful, smart, commander in chief, (coll.) cool!, sweet!
帥哥	帅哥	shuài gē	handsome guy, lady-killer, handsome (form of address)
率先	率先	shuàixiān	take lead/initiative
睡著	睡着	shuìzháo	asleep, fall_asleep, go_off, nod off, drift off, doze off, fall asleep, dope off, flake, drowse off, conk, dormant, flake out, drop off
順序	顺序	shùnxù	system, method, taxis, gradation, consecution, succession, order, ranking, rota, sequence, orderliness, turn
說不定	说不定	shuōbúdìng	perhaps, maybe
說服	说服	shuìfú	persuade, talk sb. over
思考	思考	sīkǎo	ponder over, reflect on
似乎	似乎	sìhū	it seems, quasi, apparently, seemingly, as if
鬆	松	sōng	crisp, loose, light and flaky, slack, loosen, relax, unbend, soft, not hard up
松樹	松树	sōng shù	pine, pine tree, CL:棵[ke1]
塑料	塑料	sù liào	plastics, CL:種|种[zhong3]
塑料袋	塑料袋	sù liào dài	plastic bag
酸	酸	suān	sick at heart, grieved, distressed, aching, tingling
酸奶	酸奶	suān nǎi	yogurt
隨手	随手	suí shoǔ	conveniently, without extra trouble, while doing it, in passing
孫女	孙女	sūn nǚ	son's daughter, granddaughter
孫子	孙子	sūnzi5	son's son, grandson
縮短	缩短	suōduǎn	shorten, curtail, cut down
縮小	缩小	suōxiǎo	recede, dwindle away, narrow, foreshorten, shrinkage, narrow down, abridge, minify, reduction, puncture, compress, specialize, scale down, dwindle, deflate, minish, take in, reduce, lessen, shorten, diminish, dwindle down, shrink, subside, deescalate, retract
臺階	台阶	tái jiē	steps, flight of steps, step (over obstacle), fig. way out of an embarrassing situation, bench (geology)
臺上	台上	tái shàng	on stage
躺	躺	tǎng	couch, lie, lean back, recline
套餐	套餐	tào cān	set meal, product or service package (e.g. for a cell phone subscription)
特價	特价	tè jià	special price
特殊	特殊	tèshū	exceptional, special, particular; peculiar, distinctive
特徵	特征	tèzhēng	impress, trait, hallmark, cachet, stamp, characteristic, speciality, cast, feature, characteristic marks, features, artistic style, touch, trademark, earmark, particularity, nature, genius, imprint, lineament, mold, shtick, distinction, specificity, physiognomy, idiom, signature, character, salience, diagnosis, syndrome, stigma, stylemark, signalment
提供	提供	tígōng	feed, offer, put_up, afford, proffer, set_up, capitalize, bring_forward, sponsor, extend, ply, provision, sustain, equip, supply, cough_up, bear, render, furnish, cater, billet, provide
提醒	提醒	tíxǐng	remind, warn, alert to
體操	体操	tǐcāo	jerk, physical exertion, workout, exercise, physical_exercise, gymnastic, calisthenics, exercising, gymnastics, physical exercise, gym
體檢	体检	tǐ jiǎn	abbr. for 體格檢查|体格检查[ti3 ge2 jian3 cha2]
體重	体重	tǐzhòng	body weight, beef, (body) weight, avoirdupois, weight
替	替	tì	for, on behalf of
替代	替代	tìdài	replace, supervene upon, replacement, supersede, substitute for, alternate, substitute, supersession, displace, supplant
天真	天真	tiānzhēn	naive, innocent
填	填	tián	writing, fill in, stuff, write, fill, close, charge, fill up
填空	填空	tián kòng	to fill a job vacancy, to fill in a blank (e.g. on questionnaire or exam paper)
挑	挑	tiāo	pluck, provoking, stir up, choose, incite, instigation, lance, shoulder, push sth. up, selection, carry on both ends of shoulder pole, push ... up with a pole or stick, choice, defy, prick, raise, instigate, poke, provocation, plunk, select, carry on the shoulder with a pole, push/poke sth. up, poke sth. up, pick, push, provoke
挑選	挑选	tiāoxuǎn	choose, select
調皮	调皮	tiáo pí	naughty, mischievous, unruly
挑戰	挑战	tiǎozhàn	a challenge to battle/contest
貼	贴	tiē	paste, glue, stick to
停下	停下	tíng xià	to stop
挺	挺	tǐng	very, rather, quite
通知書	通知书	tōngzhīshū	Notice
同情	同情	tóngqíng	sympathize with
童話	童话	tónghuà	fairy story, fairy tale, fairy-tale, children's stories, fairytale, fairy tales
童年	童年	tóngnián	childhood
統計	统计	tǒngjì	statistics
統一	统一	tǒngyī	unify, unite, integrate
痛快	痛快	tòng kuài	delighted, to one's heart's content, straightforward, also pr. [tong4 kuai5]
投	投	tóu	heave, agree with, throw, drop, mail, join, toss, go to, cater to, lodge, send, put into, fit in with, flip, peck, pitch, hurtle, betoss, project, deliver, stay, sky, post, cast, delivery, throw into, throw oneself into, hurl, fling, poll, vote
投入	投入	tóurù	throw/put into
投訴	投诉	toú sù	complaint, to complain, to register a complaint (esp. as a customer)
投資	投资	tóuzī	investment
透	透	toù	to penetrate, to pass through, thoroughly, completely, transparent, to appear, to show
透明	透明	tòumíng	diaphanous, see-through, crystalline, transparent
圖案	图案	túàn	miniature, device, pattern, illumination, emblem, embossment, design, imprint, cutout, designing, type
途中	途中	túzhōng	en route
土地	土地	tǔdì	country, acre, terra, soil, premise, realm, territory, dirt, local god of the land, farming, earth, ground, kingdom, holding, agrarian, solid ground, benefice, esplees, tract, village god, glebe, terra firma, land, dry land
推遲	推迟	tuī chí	to postpone, to put off, to defer
推銷	推销	tuīxiāo	promote sale of, peddle
脫	脱	tuō	cast/come off, shed, take off, escape from
襪子	袜子	wà zi	socks, stockings, CL:隻|只[zhi1],對|对[dui4],雙|双[shuang1]
外匯	外汇	wàihuì	foreign exchange
外交官	外交官	wài jiāo guān	diplomat
外套	外套	wàitào	stragulum, overclothes, outerwear, pall, surcoat, overcoat, loose coat, greatcoat, manta, outer garment, topcoat, coat, bolero, lagging, benny
彎	弯	wān	to bend, bent, a bend, a turn (in the road etc), CL:道[dao4]
晚點	晚点	wǎn diǎn	(of trains etc) late, delayed, behind schedule, light dinner
萬一	万一	wànyī	conj.: just in case, if by any chance
王	王	wáng	Rex, ameer, king, prince, emeer, monarch, shah, emir, amir, Surname, sovereign, Wang
網絡	网络	wǎng luò	Internet, network (computing, telecommunications, transport etc)
網址	网址	wǎng zhǐ	website, web address, URL
微笑	微笑	wéixiào	smile
微信	微信	Wēi xìn	Weixin or WeChat (mobile text and voice messaging service developed by Tencent 騰訊|腾讯[Teng2 xun4])
圍巾	围巾	wéi jīn	scarf, shawl, CL:條|条[tiao2]
維持	维持	wéichí	keep, preserve
維護	维护	wéihù	safeguard, defend, uphold
維修	维修	wéixiū	keep in (good) repair, maintain
尾巴	尾巴	yǐba5	appendage, a person shadowing sb., stern, tail-like part, servile adherent, tail
未必	未必	wèibì	may_not, not necessarily, may not
未來	未来	wèi lái	future, tomorrow, CL:個|个[ge4], approaching, coming, pending
位於	位于	wèiyū	be situated, situated, locate, precede, lie, come, nestle, subsist, underlie, sit, be located, skirt, rank
位置	位置	wèizhì	positioning, site, stand, stance, about-face, lie, locality, spatial relation, setting, situs, locus, slot, ubiety, station, location, emplacement, ubication, situation, niche, positional, position, place, seat
味兒	味儿	wèir	taste
喂	喂	wèi	hello, hey
穩	稳	wěn	firm, stable, steady, staid, sedate, sure, certain
穩定	稳定	wěndìng	stable, steady
問候	问候	wèn hoù	to give one's respects, to send a greeting
無	无	wú	not have, there is not
無法	无法	wúfǎ	nohow, unable to, unable, cannot
無聊	无聊	wúliáo	bored, boring, senseless, silly, stupid
無論	无论	wúlùn	conj.: no matter what/how/etc., regardless
無數	无数	wúshù	countlessness, thousand, limitlessness, infinitude, boundlessness, trillions, millions, myriad, innumerableness, unboundedness, billions, zillions, jillions, host, countless, legion, det.: innumerable, incalculability, million, infiniteness, innumerability, immensity, umpteen
無所謂	无所谓	wúsuǒwèi	not deserve the name of, be indifferent, cannot be designated as, not matter, can't be considered as
無限	无限	wúxiàn	infinite, limitless
五顏六色	五颜六色	wǔ yán liù sè	multi-colored, every color under the sun
誤會	误会	wùhuì	misunderstanding
西瓜	西瓜	xīguā	water melon, watermelon
吸	吸	xī	drop, absorption, absorb, draw to oneself, sip, breathe in, attraction, suck, suck up, sup, draw_in, puff, drink, inhale, attract, inhaust
吸管	吸管	xī guǎn	(drinking) straw, pipette, eyedropper, snorkel, CL:支[zhi1]
吸收	吸收	xīshōu	absorb, suck up, assimilate, recruit
吸煙	吸烟	xī yān	to smoke
吸引	吸引	xīyǐn	engross, arrest, appeal, fascinate, attraction, fetch, draw, transfix, pull in, entrance, pull, enamour, spellbind, enamor, capture, trance, captivate, call, grip, fascination, absorb, bewitch, tempt, becharm, speak_to, fix, engage, catch, rivet, enchant, beguile, charm, seduce, take, enwrap, magnetize, draw in, attract
喜愛	喜爱	xǐài	like, love, be fond of
系列	系列	xìliè	succession, set, spectrum, course, train, series
系統	系统	xìtǒng	lineage, filiation, scheme, pedigree, system, formation, superstructure, programme, organization, succession, tract, system of rules, organisation, program
細	细	xì	fine, exquisite, minute, in small particles, meticulous, thin and soft, thin, careful, light, trifling, slender, delicate, detailed
細節	细节	xìjié	circumstance, minutiae, nicety, minutia, speciality, item, detail, particulars, punctilio, particular, point, specific, respect, regard, details
細緻	细致	xìzhì	careful, meticulous, painstaking
下個月	下个月	xià gè yuè	next month
下降	下降	xiàjiàng	descend, go/come down, drop, fall, decline
下樓	下楼	xiàlóu	Go downstairs
下載	下载	xià zǎi	to download, also pr. [xia4 zai4]
夏季	夏季	xià jì	summer
鱻	鲜	xiǎn, xiān, xiǎn	fish, old variant of 鮮|鲜[xian3], fish, old variant of 鮮|鲜[xian1]
鮮花	鲜花	xiān huā	flower, fresh flowers, CL:朵[duo3]
鮮明	鲜明	xiānmíng	bright (of color), distinct, distinctive
鹹	咸	xián	surname Xian, salted, salty, stingy, miserly
顯著	显著	xiǎnzhù	outstand, striking, noticeable, remarkable, appear, marked, notable, outstanding, stand_out
縣	县	xiàn	county
限制	限制	xiànzhì	restrictiveness
相處	相处	xiāngchǔ	get along (with one another)
相反	相反	xiāngfǎn	offending, adverse, opposite, converse, opposite, contrary, oppose, reverse
箱	箱	xiāng	m.[container]
箱子	箱子	xiāng zi	suitcase, chest, box, case, trunk, CL:隻|只[zhi1],個|个[ge4]
想念	想念	xiǎngniàn	imagine, long to see again, remember with longing, think_of, miss, yearn
想象	想象	xiǎng xiàng	to imagine, to fancy, CL:個|个[ge4]
項	项	xiàng	m.[general]
項目	项目	xiàngmù	event, head, item, particular, article, point, specific, entry, listing, clause, project
相片	相片	xiàngpiàn	exposure, print, semblance, likeness, photo, photograph, photographic print
消化	消化	xiāohuà	digest
銷售	销售	xiāoshòu	sell, market
小吃	小吃	xiǎo chī	snack, refreshments, CL:家[jia1]
小伙子	小伙子	xiǎo huǒ zi	young man, young guy, lad, youngster, CL:個|个[ge4]
小型	小型	xiǎoxíng	spyglass, miniature, small-sized, bar, small-scale, pettiness
效率	效率	xiàolù	sufficiency, effectualness, effectuality, productiveness, usefulness, efficiency, effectivity, effectiveness
些	些	xiē	m.[proximation]
心理	心理	xīnlǐ	mental_state, psychology, mentality
新郎	新郎	xīnláng	groom, bridegroom
新娘	新娘	xīnniáng	bride
新鮮	新鲜	xīnxiān	freshen, novel, fresh, new, strange
新型	新型	xīnxíng	pattern, novelty, of new type
興奮	兴奋	xīngfèn	excited
形容	形容	xíngróng	characterize, description, describe
形勢	形势	xíng shì	circumstances, situation, terrain, CL:個|个[ge4]
型	型	xíng	mold, type, style, model
型號	型号	xíng hào	model number
醒	醒	xǐng	waken, come to, wake up, sober up, be clear in mind, regain consciousness, wake, be awake, awaken, arouse, come alive, awake, be striking to the eye
興趣	兴趣	xìngqù	relish, appetite, zestfulness, dish, cup of tea, pastime, hobby, interest, gusto, bag, avocation, zest
性質	性质	xìngzhí	kidney, attribute, fibre, description, affection, temper, nature, self, mold, temperament, property, composition, character, hair, bent, kind, disposition, habitude, meridian, dimension, quality, note, sort
兄弟	兄弟	xiōngdì	brothers
胸部	胸部	xiōngbù	chest, breast, thorax
修理	修理	xiūlǐ	repair, mend, fix
選擇	选择	xuǎnzé	select, opt
學分	学分	xuéfēn	point, semester hour, course credit, credit
學年	学年	xuénián	school/academic year
學時	学时	xué shí	class hour, period
學術	学术	xuéshù	ology, academic, systematic learning, science, learning
學問	学问	xuéwèn	lear, ology, lore, knowledge, learning, acquirement, learnedness, cognition, erudition, letter, eruditeness, scholarship
尋找	寻找	xúnzhǎo	comb, locate, quest, search, scout, chase, reconnoiter, look_around, look_for, look, look for, find_out, pick, reconnoitre, prospect, hunt, seek, rummage, shop
迅速	迅速	xùnsù	fast, speedy, rapid, prompt
牙	牙	yá	ivory, cuspid, fang, broker, tooth-like thing, tusk, tooth
牙刷	牙刷	yá shuā	toothbrush, CL:把[ba3]
亞運會	亚运会	Yà yùn huì	Asian Games
呀	呀	ya	particle: replacing 啊 when preceding word ends in a, e, i, o, or (y)u; used in direct address and exclamation; indicating obviousness/impatience/suggestion; used for confirmation
延長	延长	yáncháng	lengthen, prolong, extend
延期	延期	yán qī	to delay, to extend, to postpone, to defer
延續	延续	yánxù	continue, go on, last
嚴	严	yán	surname Yan, tight (closely sealed), stern, strict, rigorous, severe, father
嚴格	严格	yángé	rigorously enforce, rigorous, tight, grim, strict
嚴重	严重	yánzhòng	serious, significant, acute, critical, severe, grave
研究	研究	yánjiù	study, research
研究生	研究生	yánjiùshēng	don, postgraduate, grad student, grad, graduate student, student, graduate_student
研製	研制	yán zhì	to manufacture, to develop
鹽	盐	yán	salt
眼鏡	眼镜	yǎnjìng	cheater, lorgnon, spectacles, specs, glasses, spectacle, barnacles, eyeglasses, barnacle, eyeglass, glass
眼淚	眼泪	yǎnlèi	tear, teardrop, tears, eyedrop, waterworks
眼裏	眼里	yǎnlǐ	In the eyes
演講	演讲	yǎnjiǎng	lecture, speech
陽台	阳台	yángtái	veranda, pergola, patio, terrace, mirador, trysting place, balcony, gallery, piazza, gazebo, deck, verandah
養成	养成	yǎng chéng	to cultivate, to raise, to form (a habit), to acquire
腰	腰	yāo	isthmus, bend, haunch, middle, strategic pass, cingulum, reins, loin, pocket, small of the back, strait, waist of a garment, middle part, waist
搖	摇	yáo	rock, agitate, wigwag, row, pan, swing, shake, wave, scull, turn
藥物	药物	yàowù	healer, pharmic, medicine, druggery, curative, drug, pharmaceuticals, medicines, medicaments, medicinal, medicament, pharmaceutical, medication, remedy, drugs
要	要	yào	want, need, must, should
業餘	业余	yèyū	unpaid, dilettante, amateur, recreational
葉子	叶子	yèzi5	foliage, frond, leafage, leaf, leave
醫療	医疗	yīliáo	treat, cure
醫學	医学	yīxué	medicine, practice of medicine, medical science, leechcraft, physic, iatrology, medical
依靠	依靠	yīkào	rely/depend on
依然	依然	yīrán	notwithstanding, natheless, withal, even so, yet, nonetheless, nevertheless, all the same, however, still, as before
一律	一律	yīlù	equally, without exception
一再	一再	yīzài	repeatedly, again and again, time and again, over_and_over
一致	一致	yīzhì	symphonize, coheiress, identical, quadrate, accord, coincide, equate, homologize, answer, comport, concur, consist, unanimous, chime_in, agree, jibe, unite, square, correspond, consort
移	移	yí	removal, alteration, transform, shift, remove, movement, alter, change, move
移動	移动	yídòng	move, shift
移民	移民	yímín	emigrant/immigrant
遺產	遗产	yí chǎn	heritage, legacy, inheritance, bequest, CL:筆|笔[bi3]
遺傳	遗传	yíchuán	bequeath, pass on to next generation
疑問	疑问	yíwèn	interrogation, enquiry, question, interrogatory, demand, dubiousness, inquiry, interrogative, interrogative mood, doubtfulness, query, quaere, doubt
以及	以及	yǐjí	conj.: as well as, along with, and
以內	以内	yǐnèi	within, less than
一般來說	一般来说	yībānláishuō	generally speaking
義務	义务	yìwù	duty, obligation, volunteer duty
議論	议论	yìlùn	debate, discuss
引	引	yǐn	quote, cite
引導	引导	yǐndǎo	guide, lead
引進	引进	yǐnjìn	recommend, introduce from elsewhere
引起	引起	yǐnqǐ	elicit, beget, causation, give rise to, incite, pique, engender, bring_on, trigger, fire, compel, kick_up, superindividual, draw, spawn, invite, touch_off, occasion, lead, bring_about, procure, touch off, raise, enkindle, give, poke, produce, capture, generate, stir, arouse, excite, put forward, provoke, breed, bring, conjure up, grip, create, kindle, tempt, set_up, interest, give rise, enga
應	应	yīng	should, ought to
英勇	英勇	yīng yǒng	heroic, gallant, valiant
營業	营业	yíngyè	do business
贏得	赢得	yíngdé	nail down, rake_in, carry_off, nail, peg, conquer, try_for, gain, turn, win, garner, claim, earn, carry, capture, take, notch, nobble
影子	影子	yǐngzi5	umbra, sign, silhouette, reflection, trace, shadow, vague impression
勇敢	勇敢	yǒnggǎn	brave, courageous
勇氣	勇气	yǒngqì	gameness, pluck, guts, mettle, braveness, grit, heart, moxie, courage, backbone, boldness, pride, gutsiness, nerve, pecker, courageousness, valour, spirit, spunk, gallantry, valor, virtue, audacity, bravery, pluckiness, gumption, sand, gut, valiance
用途	用途	yòngtú	purpose, service, help, use, value, mileage, avail
優良	优良	yōuliáng	fine, good
優美	优美	yōuměi	graceful, exquisite
優秀	优秀	yōuxiù	outstanding, excellent
郵局	邮局	yóujú	post office
有勁兒	有劲儿	yǒu jìnr	Strength
有趣	有趣	yǒuqù	merry, fascinating, interesting, fun, amusive, comic, amusing
有限	有限	yǒuxiàn	limited, finite
幼兒園	幼儿园	yoù ér yuán	kindergarten, nursery school
於是	于是	yūshì	conj.: thereupon, hence, consequently, as a result
語法	语法	yǔfǎ	phraseology, parlance, language, syntax, locution, sentence structure, grammar, expression, wording, phrasing, phrase structure, diction
語音	语音	yǔyīn	spoken pronunciation of characters, pronunciation, spoken (vs. written) pronunciation of characters, speech sounds, phonetic
玉	玉	yū	jade
玉米	玉米	yù mǐ	corn, maize, CL:粒[li4]
預測	预测	yūcè	calculate, forecast
預訂	预订	yù dìng	to place an order, to book ahead
遇	遇	yū	meet, encounter, treat, receive
遇到	遇到	yūdào	come across, run_into, receive, meet with, encounter, run into, meet, befall
遇見	遇见	yù jiàn	to meet
原料	原料	yuánliào	making, stuff, feedstock, ingredient, primary, raw_material, fodder, material, staple, raw material
原則	原则	yuánzé	god, rule, formula, regulation, principle, fundamental, axiom, basis, linguistic rule, faith, principium
圓	圆	yuán	round, satisfactory, comprehensive
圓滿	圆满	yuánmǎn	satisfactory
約會	约会	yuē huì	appointment, engagement, date, CL:次[ci4],個|个[ge4], to arrange to meet
月底	月底	yuè dǐ	end of the month
閱讀	阅读	yuèdú	study, read, peruse
運動會	运动会	yùndònghuì	sports meeting, sport, gymkhana, athletic meeting, fixture, gate, game, sports meet, games, sports_meeting, meet
運動員	运动员	yùn dòng yuán	athlete, CL:名[ming2],個|个[ge4]
運氣	运气	yùnqì	fortune, luck
運用	运用	yùnyòng	utilize, wield, apply
再三	再三	zàisān	repeatedly, again and again, over and over again, thrice, time and again
在乎	在乎	zàihū	care about, take ... to heart, lie in, rest with, worry, care, mind
在於	在于	zàiyū	be at, on, lie, in, depend on, lie_in, rest with, lie in, be determined by, consist_in, consist in
贊成	赞成	zànchéng	endorsement, agree with, stand, assent, favor, cotton, uphold, subscribe, support, see, clear, approve, agree, sympathize, second, approve of, jibe, assist, indorse, optional, plump_for, favour, endorse
讚賞	赞赏	zàn shǎng	to admire, to praise, to appreciate
贊助	赞助	zànzhù	support, assist
造型	造型	zàoxíng	moulding, molding, style, mold, mold-making, fashioning, mould-making, modelling, model
戰鬥	战斗	zhàn doù	to fight, to battle, CL:場|场[chang2],次[ci4]
戰勝	战胜	zhàn shèng	to prevail over, to defeat, to surmount
戰士	战士	zhàn shì	fighter, soldier, warrior, CL:個|个[ge4]
戰爭	战争	zhànzhēng	war, warfare
丈夫	丈夫	zhàngfū	masterman, man, papa, manliness, mister, goodman, married man, husband, hub, hubby
招呼	招呼	zhāohū	take care lest, receive, yoo-hoo, notify, take care of, recognize, say hello to, greet, halloo, speak, notification, come up to, hail, work hard, tell, beckon, get into a fight, address, accost, mind, ask, call
著	着	zhe	[aspect]
著火	着火	zháo huǒ	to ignite, to burn
著急	着急	zhāojí	worry, feel anxious
召開	召开	zhàokāi	convene, convoke
折	折	zhé	m.[general]
針	针	zhēn	needle, pin, stitch, injection, shot, acupuncture
針對	针对	zhēnduì	in the light of, in connection with
陣	阵	zhèn	m.[event]
爭論	争论	zhēng lùn	to argue, to debate, to contend, argument, contention, controversy, debate, CL:次[ci4],場|场[chang3]
征服	征服	zhēng fú	to conquer, to subdue, to vanquish
徵求	征求	zhēngqiú	ask_for, seek, solicit
政府	政府	zhèngfǔ	sirkar, state, country, nation, governmental, body politic, government, administration, civil order, polity, commonwealth, regime, res publica, land
政治	政治	zhèngzhì	paternalism, trouble, government, policy, political relation, political science, polity, politics, political affairs, political
之後	之后	zhīhòu	later, behind, at the back of, after
之間	之间	zhījiān	among, between
之前	之前	zhīqián	before, prior to, ago
之一	之一	zhī yī	one of (sth), one out of a multitude, one (third, quarter, percent etc)
支	支	zhī	m.[general]
植物	植物	zhíwù	vegetal, flora, herb, plant, grower, vegetable, plant life, vegetation, botanical, vegetive, dwarf, vegetative
指揮	指挥	zhǐhuī	conduct, direct, command
制訂	制订	zhìdìng	work/map out, formulate
質量	质量	zhíliàng	weight, molar, mass, quantity, quality
治	治	zhì	study, research, cure, govern, treat, government, eliminate, harness, rule, manage, wipe out, management, administration, administer, control, punish, treat (disease)
治療	治疗	zhìliáo	treatment, cure
智力	智力	zhì lì	intelligence, intellect
智能	智能	zhì néng	intelligent, able, smart (phone, system, bomb etc)
中介	中介	zhōng jiè	to act as intermediary, to link, intermediate, inter-, agency, agent
種類	种类	zhǒnglèi	kidney, description, race, form, nature, manner, variety, feather, ordering, ilk, style, class, order, stamp, type, genus, category, stripe, kind, strain, cast, shape, denomination, species, persuasion, league, classification, breed, sort
中獎	中奖	zhòng jiǎng	to win a prize, a successful gamble
種	种	zhǒng	m.[kind]
種植	种植	zhòngzhí	plant, grow
重量	重量	zhòngliàng	avoirdupois weight, weight, ponderousness, heaviness, loading, heft, ponderosity, avoirdupois, heftiness, massiveness, gravity, lading
逐步	逐步	zhúbù	step by step, progressively
逐漸	逐渐	zhújiàn	step_by_step, by degrees, gradually
主題	主题	zhǔtí	motif, lemma, musical theme, theme, thesis, idea, literary argument, argument, motive, leitmotiv, matter, subject_matter, keynote, issue, subject, topic, mythos, melodic theme
主席	主席	zhǔxí	chairwoman, presiding officer, president (of organization, chair, chair (of meeting), prolocutor, chairperson, subchairman, chairmanship, state), chairman, chair/president (of organization/state), moderator, president
祝福	祝福	zhùfú	invoke blessing, wish happiness to
著名	著名	zhù míng	famous, noted, well-known, celebrated
著作	著作	zhùzuò	composition, writing, composing, oeuvre, work, opus, literature, writings, book, production, bookmaking, body of work
抓緊	抓紧	zhuā jǐn	to grasp firmly, to pay special attention to, to rush in, to make the most of
專心	专心	zhuānxīn	occupy, immerge, pore, zoom in, concentrate, betake, dive, pay attention, concentrate effort, advert, give ear, center, rivet, concentrate one's attention, focus, hang, pay heed, devote, apply, be absorbed, be absorbed in, centre, attend
轉動	转动	zhuǎndòng	turn (round), move
轉告	转告	zhuǎn gào	to pass on, to communicate, to transmit
轉身	转身	zhuǎnshēn	turn round, go_about, face about, turn
轉彎	转弯	zhuǎn wān	to turn, to go around a corner
轉移	转移	zhuǎnyí	shift, transfer, divert, change, transform
裝修	装修	zhuāngxiū	repair, renovate (house/etc.), decorate, renovate (house, etc.), renovate, furnish, renovation, fit up
裝置	装置	zhuāngzhì	install, fit
追求	追求	zhuīqiú	seek, pursue, woo, court
準時	准时	zhǔn shí	on time, punctual, on schedule
資料	资料	zīliào	food, source, info, means, data, information, material, datum, data point, matter
資源	资源	zīyuán	resource, natural resources, mine, resources
自	自	zì	from, since
自信	自信	zìxìn	self-confidence
字母	字母	zì mǔ	letter (of the alphabet), CL:個|个[ge4]
綜合	综合	zònghé	synthetical, comprehensive, multiple, composite
總共	总共	zǒnggòng	in all, all told, altogether
總理	总理	zǒnglǐ	premier, prime minister
總統	总统	zǒngtǒng	president (of a republic)
總之	总之	zǒngzhī	in a word, tout ensemble, on the whole, all in all, altogether, in short
阻止	阻止	zǔzhǐ	prevent, stop, prohibit
嘴巴	嘴巴	zuǐbā	jaw, cheeks, kisser, mouth
最初	最初	zuì chū	first, primary, initial, original, at first, initially, originally
作出	作出	zuòchū	make (decision/etc.)
作為	作为	zuòwéi	regard as, look on as, take for
做夢	做梦	zuò mèng	to dream, to have a dream, fig. illusion, fantasy, pipe dream